0110110000111001000100001011
10101100001110010001000010101
10111111111111111111111111101
11100111100011011101111010001
10101100001110010001000010100
11100111100011011101111010001
10101100001110010001000010100
11010011110001101110111101001
10011000011100100010000101100
10111111111111111111111111101
11100111100011011101111010001
0011000011100100010000101100
010011110001101110111101001
