01001101100101110001001000100001011
101110101111100011100010001000010101
1011011110110001111111111111101
010010001100110011101111010001
001000010100
11000010000000101101111010001
10101000111101100001000010100
11010011000000000000011101001
10011000011000000101000101100
10111111111111001111010111101
11100111100011011000000000001
0011000011100100010000001100
10011110001101110111101001
