1000010011110001101110111101
10110110000111001000100001000
10111111111111111111111111101
10110110000111001000100001001
10111111111111111111111111101
10110110000111001000100001001
11010011110001101110111101001
11000000000000000000000000000
10110110000111001000100001000
10111111111111111111111111101
11001001111000110111011110101
1001001111000110111011110100
000000000000000000000000000
